


NO ./texture/ocean_sq_64.png
SO ./texture/ocean1_sq_64.png

     EA ./texture/ocean3_sq_64.png


F 220,100,0
C 225,30,0
WE    ./texture/ocean2_sq_64.png		

1111111111110111111111111 111111
1000000000110000010000001          
1011000001110000000000001        
100100000000000000000000111111111 11
111111111111000001110000000000011
10000000  1100000111011111111111 
11110111111111011100000010001
11110111111111011101010010001
11000100110101011100000010001
10001000000000001100000010001
10000000000000001101010010001
11000001110101011111011110N0011
11110111 1110101 101111010001 111
11111111 1111111 111111111111