


			SO    		 ./texture/ocean1_sq_64.png
F 			255,		255,   255	
WE ./texture/ocean2_sq_64.png   
EA ./texture/ocean3_sq_64.png
   C			 90,0,0	
NO ./texture/ocean_sq_64.png
	





1111111111111111111111111       
1000000000110000000000001
1011000001110000000000001
1001000000000000000000001               
111111111011000001110000000000001
100000000011000001110111111111111           
11110111111111011100000010001
111101110111111011101010010001
11000N00110101011100000010001
10000001110000001100000010001
10000001 10000 01101010010001
11000001110101011111011110N0111
11110111 1110101 101111010001
11111111 1111111 111111111111