NO ./texture/ocean_sq.png
SO ./texture/ocean1_sq.png
WE ./texture/ocean2_sq.png
EA ./texture/ocean3_sq.png

F 220,100,0
C 225,30,0



1111111111111111111111111111111111111111111111111111111111
1000000000110000000000000000000000000111111110000000000001          
1011000000100000000000010000000000001111111100000000000011
1000000000110000000000000000000000000111111110000000000001          
10110000001000000000000100000000000000000000000000000000011
1001000000000000000000001111111111111111111111111111111111
1011000000100000000000010000000000001111111100000000000011
110000001101010111000000100011111111000111111111111111111
1000100000000000110000001000000000000000000001111
1000000000000001100000000000000000011010100100011111111111
1000000000110000000000000000000000000111111110000000000001          
1011000000100000000000010000000000001111111100000000000011
1111111111110000011100000000000111111111111111111111111111
100000001 1100000000000E0000000000000000000111011111111111 
1111011111111101110000000000000000000000000000000000010001
1111011111111101110101001010000000000001111111111111111111
1000000000110000000000000000000000000111111110000000000001          
1011000000100000000000010000000000001111111100000000000011
110000001101000111000000100011111111000111111111111111111
1000100000000000110000001000000000000000000001111
1000000000000001100000000000000000011010100100011
11000001110101011111000000000011110001111111111111111111111
11110111 1110101 101111010001111000000000000000000000000111
11110111 1111111 111111111111111111111111111111111111111111
111111111111111111111111111111
