NO ./texture/ocean_sq.png
SO ./texture/ocean1_sq.png
WE ./texture/ocean2_sq.png
EA ./texture/ocean3_sq.png

F 56,32,193 
C 19,44,23

11111111111111              1111111111111111
11000000000101              11010000000000011
10000000000001111111        1100100000000011
1000S000001111     1        1010010000000001
10000000000001111111        1010010000000001
11000000000001111111111111111111111111100001
10000000000000000000000000000000000000000011
11000000000000000000000000000000000000000011
1000000000000111111111111111111111111111111111
10000111111000000001               1111    111
110001000000011111111111           1   1111  1
10000100000001 1 11111111         11         1
1000010000001111111               11         1
1000011000000000011                1        11
100001111111000011                 11111111111
10000000000001111
11111111111111