NO ./texture/ocean_sq_64.png
SO ./texture/ocean1_sq_64.png
WE ./texture/ocean2_sq_64.png
EA ./texture/ocean3_sq_64.png
F 0,153,15 
C 255,255,255
        1111111111111111111111111
        1000000000000000000000001
        1100000000000000000000001
        1000000000000000000000001
111111111000000000000000000000001
100000000000000000000000000001111
10000000000000E111111100000001
1000000000000001    1100000001
1000000000000001 1111000000011
1000000000000001 1010100000001
1000000000000001 1000000000001
1100000111010101 1111011111111
11110111 1110111 101111010001
11111111 1111111 111111111111
